111111111111
10000E1000C1
100CD000D001
1D1000P00001
111111111111
