1111111111
10E000C001
1000C00001
100P000D01
1111111111
