11111111111
10E00000001
1C0000C00001
10C0000P001
11111111111
