11111111111
10E00000001
1C0000C0001
10C0000P001
11111101111
