11111111111
10E00000001
10000000001
1000000P001
11111111111
