11111111111
10000000001
1C0000C0001
10C0000P001
11111111111
