11111111111
10000C000E1
10C00000C01
1000000C001
11111111111
