111111111
100000C11
100000001
100000001
