11111
10E01
1C0P1
10C01
11111
