1111111111111111
10000C000000C001

10000E0000C00001
1000P00000000001
1111111111111111
