111111111111
10E000000001
10000C001001
10C0000P1001
111111111111




