11111111111
10E00000P01
1C0000C0001
10C0000P001
11111111111
