11111111111
100J0000001
1C0000P0001
1E000C00001
11111111111
